textures/darkmod/stone/floor/blocks_001	textures/darkmod/stone/brick/rough_blocks02
textures/darkmod/stone/floor/blocks_002_yellow	textures/darkmod/stone/brick/rough_blocks_tight_light
textures/darkmod/stone/floor/blocks_002_blue	textures/darkmod/stone/brick/rough_blocks_tight_dark
textures/darkmod/stone/floor/blocks_003	textures/darkmod/stone/brick/rough_blocks_tight02
textures/darkmod/stone/floor/blocks_003_mossy	textures/darkmod/stone/brick/rough_blocks_tight02_moss
textures/darkmod/stone/floor/blocks_004	textures/darkmod/stone/brick/tight_large_blocks
textures/darkmod/stone/floor/blocks_005	textures/darkmod/stone/brick/grey_protruding_bricks
textures/darkmod/stone/floor/blocks_006	textures/darkmod/stone/brick/grainy_blocks01
textures/darkmod/stone/floor/blocks_007	textures/darkmod/stone/brick/tight_randomsize_blocks
textures/darkmod/stone/floor/blocks_008	textures/darkmod/stone/brick/rough_big_blocks01
textures/darkmod/stone/floor/blocks_009	textures/darkmod/stone/brick/rough_big_blocks02
textures/darkmod/stone/floor/blocks_009_cornerstone_dark	textures/darkmod/stone/brick/rough_big_blocks02_cornerstone_dark
textures/darkmod/stone/floor/blocks_009_cornerstone_light	textures/darkmod/stone/brick/rough_big_blocks02_cornerstone_light
textures/darkmod/stone/floor/blocks_010	textures/darkmod/stone/brick/rough_big_blocks03
textures/darkmod/stone/floor/blocks_010_cornerstone_dark	textures/darkmod/stone/brick/rough_big_blocks03_cornerstone_dark
textures/darkmod/stone/floor/blocks_010_cornerstone_light	textures/darkmod/stone/brick/rough_big_blocks03_cornerstone_light
textures/darkmod/stone/floor/blocks_011	textures/darkmod/stone/cobblestones/uneven_blocks01_dark
textures/darkmod/stone/floor/blocks_012	textures/darkmod/stone/cobblestones/uneven_blocks01_brown
textures/darkmod/stone/floor/blocks_013	 textures/darkmod/stone/brick/rough_big_blocks04_brown
textures/darkmod/stone/floor/blocks_013_cornerstone_light	textures/darkmod/stone/brick/rough_big_blocks04_brown_cornerstone_light
textures/darkmod/stone/floor/blocks_014	textures/darkmod/stone/brick/rough_big_blocks05
textures/darkmod/stone/floor/blocks_015	textures/darkmod/stone/brick/tight_large_blocks01
textures/darkmod/stone/floor/blocks_016	textures/darkmod/stone/brick/tight_large_singleblock01
textures/darkmod/stone/floor/blocks_017	textures/darkmod/stone/brick/grainy_large_blocks01
textures/darkmod/stone/floor/blocks_018	textures/darkmod/stone/cobblestones/flagstones02_plain
textures/darkmod/stone/floor/blocks_018_cornerstone_l	textures/darkmod/stone/cobblestones/flagstones02_plain_cornerstone_left
textures/darkmod/stone/floor/blocks_018_cornerstone_r	 textures/darkmod/stone/cobblestones/flagstones02_plain_cornerstone_right
textures/darkmod/stone/floor/blocks_018_window01	textures/darkmod/stone/cobblestones/flagstones02_plain_window01
textures/darkmod/stone/floor/blocks_018_window02	textures/darkmod/stone/cobblestones/flagstones02_plain_window02
textures/darkmod/stone/floor/blocks_019	textures/darkmod/stone/brick/even_small_blocks01
textures/darkmod/stone/floor/brick_001	textures/darkmod/stone/brick/red_brick_dull01
textures/darkmod/stone/floor/brick_002	textures/darkmod/stone/brick/redbrick_dull_small
textures/darkmod/stone/floor/brick_004	textures/darkmod/stone/brick/red_angled_ground
textures/darkmod/stone/floor/brick_005	textures/darkmod/stone/brick/red_sloppymortar
textures/darkmod/stone/floor/brick_005_colored	textures/darkmod/stone/brick/sloppymortar_colored
textures/darkmod/stone/floor/brick_005_dark	textures/darkmod/stone/brick/red_sloppymortar_dark
textures/darkmod/stone/floor/brick_005_inverted	textures/darkmod/stone/brick/red_sloppymortar_inverted
textures/darkmod/stone/floor/brick_006	textures/darkmod/stone/brick/even_greyish01
textures/darkmod/stone/floor/brick_006_trim	textures/darkmod/stone/brick/even_greyish01_trim
textures/darkmod/stone/floor/brick_007	textures/darkmod/stone/brick/interlocking_angled_grey
textures/darkmod/stone/floor/brick_007_dark	textures/darkmod/stone/brick/interlocking_angled_darkgrey
textures/darkmod/stone/floor/brick_007_yellow	textures/darkmod/stone/brick/interlocking_angled_yellow
textures/darkmod/stone/floor/brick_008	textures/darkmod/stone/brick/redbrick_mostly_mortar
textures/darkmod/stone/floor/brick_009	textures/darkmod/stone/brick/rough_blocks01
textures/darkmod/stone/floor/brick_010	textures/darkmod/stone/brick/old_blocks_wornsmooth_dark
textures/darkmod/stone/floor/cobble_001	textures/darkmod/stone/cobblestones/cobblestones03_dark
textures/darkmod/stone/floor/cobble_002	textures/darkmod/stone/cobblestones/cobblestones04_multicolour
textures/darkmod/stone/floor/cobble_003	textures/darkmod/stone/cobblestones/flagstones05_pinkish
textures/darkmod/stone/floor/cobble_004	textures/darkmod/stone/cobblestones/cobblestones01_square_light
textures/darkmod/stone/floor/cobble_004_nospecular	textures/darkmod/stone/cobblestones/cobblestones01_square_light_nospecular
textures/darkmod/stone/floor/cobble_005	textures/darkmod/stone/brick/interlocking_mixedsize_dark
textures/darkmod/stone/floor/cobble_006	textures/darkmod/stone/cobblestones/flagstones03_shiny
textures/darkmod/stone/floor/cobble_007	textures/darkmod/stone/cobblestones/flagstones04_uneven
textures/darkmod/stone/floor/cobble_008	textures/darkmod/stone/cobblestones/cobblestones02_square_dark
textures/darkmod/stone/floor/cobble_mossy_001	textures/darkmod/stone/cobblestones/cobblestones_loose_ongrass
textures/darkmod/stone/floor/decorative_001	textures/darkmod/stone/flat/ceramic_mosaic_decorative01
textures/darkmod/stone/floor/fan_001_dirt	textures/darkmod/stone/cobblestones/cobblestone_fan_pattern
textures/darkmod/stone/floor/fan_001_grass	textures/darkmod/stone/cobblestones/cobblestone_fan_pattern_grass
textures/darkmod/stone/floor/granite_001	textures/darkmod/stone/cobblestones/flagstones06_granite
textures/darkmod/stone/floor/marble_004	textures/darkmod/stone/flat/rough_marble_dark01
textures/darkmod/stone/floor/masonry_001	textures/darkmod/stone/cobblestones/flagstones01_light
textures/darkmod/stone/floor/masonry_001_brick	textures/darkmod/stone/brick/small_brown_bricks01
textures/darkmod/stone/floor/masonry_001_pillar	textures/darkmod/stone/brick/pillar_bricks01
textures/darkmod/stone/floor/mortared_001	textures/darkmod/stone/cobblestones/blocks_mixed_multicolour
textures/darkmod/stone/floor/rough_001	textures/darkmod/stone/natural/dark_dirt_smeary
textures/darkmod/stone/floor/rough_002	textures/darkmod/stone/natural/sandstone
textures/darkmod/stone/floor/rough_003	textures/darkmod/stone/natural/rock_grey
textures/darkmod/stone/floor/rough_003_dark	textures/darkmod/stone/natural/rock_grey_dark
textures/darkmod/stone/floor/rough_004	textures/darkmod/stone/natural/rock_brown_mottled
textures/darkmod/stone/floor/rough_005	textures/darkmod/stone/natural/light_grey_rough
textures/darkmod/stone/floor/rough_006	textures/darkmod/stone/flat/rough_marble_dark02
textures/darkmod/stone/floor/rough_007	textures/darkmod/stone/flat/rough_marble_light01
textures/darkmod/stone/floor/rough_008	textures/darkmod/stone/natural/rough_old
textures/darkmod/stone/floor/rough_009	textures/darkmod/stone/natural/dark_rough
textures/darkmod/stone/floor/rough_010	textures/darkmod/stone/natural/dark_dirty
textures/darkmod/stone/floor/rough_011	textures/darkmod/stone/natural/rough_grey_dirty
textures/darkmod/stone/floor/rough_012_mossy	textures/darkmod/stone/natural/rock_grey_mossy
textures/darkmod/stone/floor/tiled_001	textures/darkmod/stone/flat/tiles_rough_grey
textures/darkmod/stone/floor/tiled_002	textures/darkmod/stone/cobblestones/nontiling/flagstones_jagged_grey
textures/darkmod/stone/floor/tiled_003	textures/darkmod/stone/flat/tile_plain_diamond01_brown
textures/darkmod/stone/floor/tiled_004	textures/darkmod/stone/flat/smooth/ceramic_tile_reddish01
textures/darkmod/stone/floor/tiled_005	textures/darkmod/stone/flat/smooth/ceramic_tile_gold01
textures/darkmod/stone/floor/tiled_006	textures/darkmod/stone/flat/smooth/ceramic_tile_tan02
textures/darkmod/stone/floor/tiled_007	textures/darkmod/stone/flat/smooth/ceramic_tile_tan03
textures/darkmod/stone/floor/tiled_008	textures/darkmod/stone/flat/smooth/ceramic_tile_tan01
textures/darkmod/stone/floor/tiled_009	textures/darkmod/stone/flat/rough_plain_tiles01
textures/darkmod/stone/floor/tiled_010	textures/darkmod/stone/flat/rough_slate_tiles01_dark

textures/darkmod/stone/trim/border_8x1	textures/darkmod/stone/sculpted/trapezoid_tile_8x1
textures/darkmod/stone/trim/border_4x1	textures/darkmod/stone/sculpted/trapezoid_tile_4x1
textures/darkmod/stone/trim/border_2x1	textures/darkmod/stone/sculpted/trapezoid_tile_2x1
textures/darkmod/stone/trim/border_1x1	textures/darkmod/stone/sculpted/trapezoid_tile_1x1
textures/darkmod/stone/trim/deco_001	textures/darkmod/stone/sculpted/engraved_tile_star
textures/darkmod/stone/trim/deco_002	textures/darkmod/stone/sculpted/engraved_tile_ovals
textures/darkmod/stone/trim/grave_001	textures/darkmod/stone/sculpted/sarcophagus_warrior01
textures/darkmod/stone/trim/grave_002	textures/darkmod/stone/sculpted/sarcophagus_cup&hammer01
textures/darkmod/stone/trim/grave_003	textures/darkmod/stone/sculpted/sarcophagus_wings01
textures/darkmod/stone/trim/grave_004	textures/darkmod/stone/sculpted/sarcophagus_swords&shield01
textures/darkmod/stone/trim/grave_005	textures/darkmod/stone/sculpted/engraved_tile_cup01
textures/darkmod/stone/trim/grave_006	textures/darkmod/stone/sculpted/engraved_tile_x
textures/darkmod/stone/trim/grave_007	textures/darkmod/stone/sculpted/engraved_tile_impface
textures/darkmod/stone/trim/grave_008	textures/darkmod/stone/sculpted/engraved_tile_ring
textures/darkmod/stone/trim/ornament_001	textures/darkmod/stone/sculpted/carved_tiles01_x4_light
textures/darkmod/stone/trim/ornament_002	textures/darkmod/stone/sculpted/carved_tiles01_x4_dark
textures/darkmod/stone/trim/ornament_003	textures/darkmod/stone/sculpted/royal_emblem01
textures/darkmod/stone/trim/ornament_004	textures/darkmod/stone/sculpted/tiling_1d/marble_ancient_writing
textures/darkmod/stone/trim/ornament_005	textures/darkmod/stone/sculpted/tiles_bars_diamondshape
textures/darkmod/stone/trim/ornament_006	textures/darkmod/stone/sculpted/tile_empty_square
textures/darkmod/stone/trim/ornament_007	textures/darkmod/stone/sculpted/tile_empty_trapezoid
textures/darkmod/stone/trim/ornament_008	textures/darkmod/stone/sculpted/tile_diamond_trapezoid
textures/darkmod/stone/trim/ornament_009	textures/darkmod/stone/sculpted/engraved_tile_face01
textures/darkmod/stone/trim/ornament_010	textures/darkmod/stone/sculpted/carved_design_diamonds01
textures/darkmod/stone/trim/ornament_011	textures/darkmod/stone/sculpted/carved_design_bones01
textures/darkmod/stone/trim/ornament_012	textures/darkmod/stone/sculpted/carved_design_snakes
textures/darkmod/stone/trim/ornament_013_tile_mid	textures/darkmod/stone/sculpted/carved_design_bones02
textures/darkmod/stone/trim/ornament_013_tile_right	textures/darkmod/stone/sculpted/carved_design_bones02_right
textures/darkmod/stone/trim/ornament_013_tile_left	textures/darkmod/stone/sculpted/carved_design_bones02_left
textures/darkmod/stone/trim/ornament_014_skull	textures/darkmod/stone/sculpted/carved_design_skull01
textures/darkmod/stone/trim/trim_001	textures/darkmod/stone/sculpted/carved_diamond_trim02
textures/darkmod/stone/trim/trim_002	textures/darkmod/stone/sculpted/carved_diamond_trim
textures/darkmod/stone/trim/trim_003	textures/darkmod/stone/brick/single_grey_block01

textures/darkmod/stone/wall/blocks_001_framed	textures/darkmod/stone/brick/nontiling/chiseled_brick_frame
textures/darkmod/stone/wall/brick_old_001	textures/darkmod/stone/brick/old_small_bricks_grey
textures/darkmod/stone/wall/brick_old_002	textures/darkmod/stone/brick/tiling_1d/old_worn_greybrick
textures/darkmod/stone/wall/brick_old_003	textures/darkmod/stone/brick/old_dirty_bricks01
textures/darkmod/stone/wall/cement_001	textures/darkmod/stone/flat/tiling_1d/concrete_light_cracked
textures/darkmod/stone/wall/cement_003	textures/darkmod/stone/flat/tiling_1d/concrete_rough_dark01
textures/darkmod/stone/wall/cement_006	textures/darkmod/stone/flat/tiling_1d/concrete_rough_pebbly
textures/darkmod/stone/wall/cement_009	textures/darkmod/stone/flat/tiling_1d/concrete_rough_dark02
textures/darkmod/stone/wall/cement_011	textures/darkmod/metal/flat/tiling_1d/rough_rusted01
textures/darkmod/stone/wall/cement_012	textures/darkmod/metal/flat/tiling_1d/rough_dirty01
textures/darkmod/stone/wall/cement_013	textures/darkmod/stone/flat/tiling_1d/concrete_light_streaked
textures/darkmod/stone/wall/cement_014	textures/darkmod/metal/flat/tiling_1d/rough_iron01
textures/darkmod/stone/wall/facade_001	textures/darkmod/window/frame_ornate_wallsection_lit
textures/darkmod/stone/wall/masonry_001	textures/darkmod/stone/cobblestones/tiling_1d/blocks_uneven02_grey
textures/darkmod/stone/wall/masonry_002	textures/darkmod/stone/cobblestones/tiling_1d/blocks_uneven03_grey
textures/darkmod/stone/wall/masonry_003	textures/darkmod/stone/cobblestones/tiling_1d/blocks_uneven04_brown
textures/darkmod/stone/wall/masonry_004	textures/darkmod/stone/cobblestones/tiling_1d/blocks_uneven05_grey
textures/darkmod/stone/wall/masonry_005	textures/darkmod/stone/cobblestones/blocks_mixedsize01
textures/darkmod/stone/wall/masonry_old_001	textures/darkmod/stone/cobblestones/tiling_1d/bricks_blocks_mix
textures/darkmod/stone/wall/masonry_old_002	textures/darkmod/stone/cobblestones/tiling_1d/bricks_blocks_roughmix
textures/darkmod/stone/wall/masonry_old_003	textures/darkmod/stone/cobblestones/tiling_1d/flagstones_sparse
textures/darkmod/stone/wall/masonry_old_004	textures/darkmod/stone/cobblestones/rough_masonry01
textures/darkmod/stone/wall/masonry_old_005	textures/darkmod/stone/cobblestones/tiling_1d/flagstones_uneven
textures/darkmod/stone/wall/mortared_001	textures/darkmod/stone/cobblestones/blocks_mixed_multicolour_framed
textures/darkmod/stone/wall/rounded_001	textures/darkmod/stone/cobblestones/tiling_1d/cobblestones_rounded

textures/darkmod/foliage/trim/hanging_001	textures/darkmod/decals/vegetation/hanging_horizontal_leaves
textures/darkmod/foliage/trim/ivy_001_patch1	textures/darkmod/decals/vegetation/ivypatch_average01
textures/darkmod/foliage/trim/ivy_001_patch2	textures/darkmod/decals/vegetation/ivypatch_large01
textures/darkmod/foliage/trim/ivy_001_small1	textures/darkmod/decals/vegetation/ivypatch_small01
textures/darkmod/foliage/trim/ivy_001_small2	textures/darkmod/decals/vegetation/ivypatch_tiny01
textures/darkmod/foliage/trim/ivy_002_collection	textures/darkmod/decals/vegetation/ivy_mixed_pieces
textures/darkmod/foliage/trim/ivy_002_collection_dark	textures/darkmod/decals/vegetation/ivy_mixed_pieces_dark
textures/darkmod/foliage/trim/ivy_003	textures/darkmod/decals/vegetation/ivy_vertical_branches
textures/darkmod/foliage/trim/ivy_004	textures/darkmod/decals/vegetation/ivy_scattered_branches
textures/darkmod/foliage/trim/moss	textures/darkmod/decals/vegetation/moss_patch_thick01
textures/darkmod/foliage/trim/moss_burn	textures/darkmod/decals/vegetation/moss_patch_thick01_burning

textures/darkmod/pagan/decal/pagdecfleur.tga	textures/darkmod/decals/symbols/magic_symbol_circle01
textures/darkmod/pagan/decal/pagdecvoyn.tga	textures/darkmod/decals/symbols/magical_letters_row01

textures/darkmod/door/antique_001	textures/darkmod/door/wood/oldboards_metalspirals01
textures/darkmod/door/attic_001	textures/darkmod/door/wood/old_flat_oak01
textures/darkmod/door/mansion_001	textures/darkmod/door/wood/smooth_4panels_red01
textures/darkmod/door/mansion_001_light	textures/darkmod/door/wood/smooth_4panels_tan01
textures/darkmod/door/mansion_002	textures/darkmod/door/wood/smooth_3panels_red01
textures/darkmod/door/mansion_003	textures/darkmod/door/wood/smooth_3panels01_dull01
textures/darkmod/door/mansion_004	textures/darkmod/door/wood/smooth_2panels_rich
textures/darkmod/door/reinforced_001	textures/darkmod/door/wood/metalbands_crisscross01
textures/darkmod/door/sturdy_001	textures/darkmod/door/wood/diamond_pattern01
textures/darkmod/door/weathered_001	textures/darkmod/door/wood/old_weathered_boards01
textures/darkmod/door/windowed_001	textures/darkmod/door/wood/ornate/smooth_rich_ovalwindow01
textures/darkmod/door/windowed_002	textures/darkmod/door/wood/ornate/smooth_rich_squarewindow01

textures/darkmod/wood/ceiling/panel_001	textures/darkmod/wood/panels/panel_grey
textures/darkmod/wood/ceiling/panel_002	textures/darkmod/wood/panels/panel_carved_star
textures/darkmod/wood/ceiling/panel_002_dusty	textures/darkmod/wood/panels/panel_carved_star_dusty
textures/darkmod/wood/ceiling/panel_003	textures/darkmod/wood/panels/panel_carved_rectangles_01
textures/darkmod/wood/ceiling/panel_004_dark	textures/darkmod/wood/panels/panel_carved_rectangles_02_dark
textures/darkmod/wood/ceiling/panel_004_light	textures/darkmod/wood/panels/panel_carved_rectangles_02_light
textures/darkmod/wood/ceiling/panel_005	textures/darkmod/wood/panels/panel_floral_ornaments
textures/darkmod/wood/ceiling/panel_006	textures/darkmod/wood/panels/panel_carved_round_dark
textures/darkmod/wood/ceiling/plastered_001	textures/darkmod/wood/boards/plastered_grey
textures/darkmod/wood/ceiling/pole_supports	textures/darkmod/wood/boards/metal_decorated
textures/darkmod/wood/floor/bark_001	textures/darkmod/nature/natural02
textures/darkmod/wood/floor/boards_old_001	textures/darkmod/wood/boards/old_small_grainy
textures/darkmod/wood/floor/boards_old_002	textures/darkmod/wood/boards/weathered
textures/darkmod/wood/floor/boards_old_003	textures/darkmod/wood/boards/scratched
textures/darkmod/wood/floor/boards_old_004	textures/darkmod/wood/boards/dark_rough
textures/darkmod/wood/floor/boards_old_005	textures/darkmod/wood/boards/worn_01
textures/darkmod/wood/floor/boards_old_006	textures/darkmod/wood/boards/worn_02
textures/darkmod/wood/floor/boards_old_007	textures/darkmod/wood/boards/dark_varnished
textures/darkmod/wood/floor/boards_polished_001	textures/darkmod/wood/boards/polished_shiny
textures/darkmod/wood/floor/boards_polished_002	textures/darkmod/wood/boards/polished_01
textures/darkmod/wood/floor/boards_polished_002_dim	textures/darkmod/wood/boards/polished_01_dim
textures/darkmod/wood/floor/tile_decorative_001	textures/darkmod/stone/flat/ceramic_mosaic_decorative01
textures/darkmod/wood/floor/tile_weave_001	textures/darkmod/wood/panels/tile_weave
textures/darkmod/wood/trim/beam_001	textures/darkmod/wood/boards/worn_large
textures/darkmod/wood/trim/beam_002	textures/darkmod/wood/panels/beam_rough_brown
textures/darkmod/wood/trim/beam_002_endcap	textures/darkmod/wood/panels/nontiling/beam_rough_brown_endcap
textures/darkmod/wood/trim/beam_002_weathered	textures/darkmod/wood/panels/beam_rough_weathered
textures/darkmod/wood/trim/beam_002_weathered_endcap	textures/darkmod/wood/panels/nontiling/beam_rough_weathered_endcap
textures/darkmod/wood/trim/beam_003	textures/darkmod/wood/panels/beam_brown_old
textures/darkmod/wood/trim/beam_003_burnt	textures/darkmod/wood/panels/nontiling/beam_brown_old_burnt
textures/darkmod/wood/trim/beam_003_endcap	textures/darkmod/wood/panels/nontiling/beam_brown_old_endcap
textures/darkmod/wood/trim/beam_mossy_001	textures/darkmod/wood/panels/beam_old_mossy
textures/darkmod/wood/trim/molding_001	textures/darkmod/wood/panels/trim_carved_rounded
textures/darkmod/wood/trim/molding_002	textures/darkmod/wood/panels/molding_leaves
textures/darkmod/wood/trim/molding_003	textures/darkmod/wood/panels/molding_decorative_dark
textures/darkmod/wood/trim/molding_004	textures/darkmod/wood/panels/molding_grey
textures/darkmod/wood/trim/panel_001	textures/darkmod/wood/panels/trim_carved_long
textures/darkmod/wood/trim/panel_002	textures/darkmod/wood/panels/thin_panels_with_trim_dark
textures/darkmod/wood/trim/panel_003	textures/darkmod/wood/panels/thin_panels_with_trim_light
textures/darkmod/wood/trim/plastered_001	textures/darkmod/wood/plaster/framed_old_01
textures/darkmod/wood/trim/plastered_001_decorative	textures/darkmod/wood/plaster/framed_old_decorative_01
textures/darkmod/wood/wall/boards_new_001	textures/darkmod/wood/boards/tiling_1d/new_grainy
textures/darkmod/wood/wall/building_001	textures/darkmod/city/wall/ctywall04
textures/darkmod/wood/wall/panel_001	textures/darkmod/wood/panels/panels_decorative_arched
textures/darkmod/wood/wall/panel_002	textures/darkmod/wood/panels/panels_grey_long
textures/darkmod/wood/wall/panel_003	textures/darkmod/wood/panels/panel_hammer
textures/darkmod/wood/wall/panel_004	textures/darkmod/wood/panels/panel_decorative_rectangles
textures/darkmod/wood/wall/panel_005	textures/darkmod/wood/panels/panel_circle_face
textures/darkmod/wood/wall/panel_006	textures/darkmod/wood/panels/panel_warrior
textures/darkmod/wood/wall/panel_007	textures/darkmod/wood/panels/panel_decorative_frame
textures/darkmod/wood/wall/panel_008	textures/darkmod/wood/panels/panel_decorative_frame_long
textures/darkmod/wood/wall/panel_009	textures/darkmod/mansion/wall/manwcapital01.tga
textures/darkmod/wood/wall/wallpaper_001	textures/darkmod/paint_paper/wallpaper_flowers_01
textures/darkmod/wood/wall/wallpaper_002_blue	textures/darkmod/paint_paper/wallpaper_ornamental_01_blue
textures/darkmod/wood/wall/wallpaper_002_green	textures/darkmod/paint_paper/wallpaper_ornamental_01_green
textures/darkmod/wood/wall/wallpaper_002_pink	textures/darkmod/paint_paper/wallpaper_ornamental_01_pink
textures/darkmod/wood/wall/wallpaper_002_red	textures/darkmod/paint_paper/wallpaper_ornamental_01_red
textures/darkmod/wood/wall/wallpaper_003	textures/darkmod/paint_paper/wallpaper_ornamental_02_white
textures/darkmod/litwindows/largeround100	textures/darkmod/window/ornate/round_spokes01_brightlit
textures/darkmod/litwindows/largesquare100	textures/darkmod/window/largesquare01_brightlit
textures/darkmod/litwindows/smallsquare100	textures/darkmod/window/simple_square01_brightlit
textures/darkmod/litwindows/largeround90	textures/darkmod/window/ornate/round_spokes01_lit
textures/darkmod/litwindows/largesquare90	textures/darkmod/window/largesquare01_lit
textures/darkmod/litwindows/smallsquare90	textures/darkmod/window/simple_square01_lit
textures/darkmod/litwindows/largeround80	textures/darkmod/window/ornate/round_spokes01_softlit
textures/darkmod/litwindows/largesquare80	textures/darkmod/window/largesquare01_softlit
textures/darkmod/litwindows/smallsquare80	textures/darkmod/window/simple_square01_softerlit
textures/darkmod/litwindows/largeround70	textures/darkmod/window/ornate/round_spokes01_softerlit
textures/darkmod/litwindows/largesquare70	textures/darkmod/window/largesquare01_softerlit
textures/darkmod/litwindows/smallsquare70	textures/darkmod/window/simple_square01_softlit
textures/darkmod/tile/trim/molding_001	textures/darkmod/stone/flat/smooth/tiling_1d/marble_trim01_brown
textures/darkmod/tile/floor/marble_001	textures/darkmod/stone/flat/smooth/marble_pattern01
textures/darkmod/tile/floor/marble_001_center1	textures/darkmod/stone/flat/smooth/marble_pattern01_centersun
textures/darkmod/tile/floor/marble_001_center2	textures/darkmod/stone/flat/smooth/marble_pattern01_centerrose
textures/darkmod/tile/floor/marble_002_center1_squares	textures/darkmod/stone/flat/smooth/marble_pattern02_checker
textures/darkmod/tile/floor/marble_002_center2	textures/darkmod/stone/flat/smooth/marble_pattern02_crosshair
textures/darkmod/tile/floor/marble_002_center3	textures/darkmod/stone/flat/smooth/marble_pattern02_star
textures/darkmod/tile/floor/marble_002_center4	textures/darkmod/stone/flat/smooth/marble_pattern02_star02
textures/darkmod/tile/floor/marble_002_center5_gear	textures/darkmod/stone/flat/smooth/marble_pattern02_rings
textures/darkmod/tile/floor/marble_001_polished	textures/darkmod/stone/flat/smooth/marble_pattern01_polished
textures/darkmod/tile/floor/marble_001_center1_polished	textures/darkmod/stone/flat/smooth/marble_pattern01_centersun_polished
textures/darkmod/tile/floor/marble_001_center2_polished	textures/darkmod/stone/flat/smooth/marble_pattern01_centerrose_polished
textures/darkmod/tile/floor/marble_002_center1_squares_polished	textures/darkmod/stone/flat/smooth/marble_pattern02_checker_polished
textures/darkmod/tile/floor/marble_002_center2_polished	textures/darkmod/stone/flat/smooth/marble_pattern02_crosshair_polished
textures/darkmod/tile/floor/marble_002_center3_polished	textures/darkmod/stone/flat/smooth/marble_pattern02_star_polished
textures/darkmod/tile/floor/marble_002_center4_polished	textures/darkmod/stone/flat/smooth/marble_pattern02_star02_polished
textures/darkmod/tile/floor/marble_002_center5_gear_polished	textures/darkmod/stone/flat/smooth/marble_pattern02_rings_polished
textures/darkmod/tile/floor/marble_003	textures/darkmod/stone/flat/smooth/marble_pattern03_brownish
textures/darkmod/metal/trim/panel_001	textures/darkmod/metal/detailed/panel_circledesign01_green
textures/darkmod/metal/trim/panel_001_etched	textures/darkmod/metal/detailed/panel_circledesign01_green_etched
textures/darkmod/metal/floor/grating_001	textures/darkmod/metal/grate/dimpled_grating01
textures/darkmod/metal/floor/rust_002	textures/darkmod/metal/flat/heavy_rust_pocked01
textures/darkmod/metal/floor/rust_003	textures/darkmod/metal/flat/solid_rust01
textures/darkmod/metal/floor/rust_004	textures/darkmod/metal/flat/simple_rough_grey01
textures/darkmod/metal/floor/rust_005	textures/darkmod/metal/flat/solid_rust02
textures/darkmod/gravel/floor/gravel_001	textures/darkmod/stone/natural/tiling_1d/gravel_grey_01
textures/darkmod/grass/floor/grassy_001	textures/darkmod/nature/grass/thick_grass01
textures/darkmod/grass/floor/grassy_002	textures/darkmod/nature/grass03
textures/darkmod/grass/floor/grassy_003	textures/darkmod/nature/grass04
textures/darkmod/grass/floor/mossyrock_001	textures/darkmod/stone/natural/mossy_rock_green
textures/darkmod/grass/floor/mossyrock_002	textures/darkmod/stone/natural/mossy_rock_brown
textures/darkmod/grass/floor/mossyrock_003	textures/darkmod/stone/natural/mossy_rock_bumpy
textures/darkmod/grass/floor/underbrush_001	textures/darkmod/nature/grass/short_patchy_grass01
textures/darkmod/grass/floor/straw_001	textures/darkmod/nature/grass/nontiling/thick_straw01
textures/darkmod/carpet/trim/rug_001	textures/darkmod/carpet/rugs/ornate_rectangles_brown01
textures/darkmod/carpet/trim/rug_002	textures/darkmod/carpet/rugs/ornate_floral_checker01
textures/darkmod/carpet/trim/rug_blue_001	textures/darkmod/carpet/rugs/ornate_green_black01
textures/darkmod/carpet/trim/rug_gold_001	textures/darkmod/carpet/rugs/ornate_black_gold01
textures/darkmod/carpet/trim/rug_red_001	textures/darkmod/carpet/rugs/ornate_red_tan01
textures/darkmod/carpet/trim/rug_red_002	textures/darkmod/carpet/rugs/ornate_red_tan02
textures/darkmod/carpet/trim/rug_red_003_center	textures/darkmod/carpet/runners/geometric01_red
textures/darkmod/carpet/trim/rug_red_003_end	textures/darkmod/carpet/runners/geometric01_red_end
textures/darkmod/city/wall/metal02	textures/darkmod/metal/flat/simple_grey01
textures/darkmod/city/wall/brick_dark	textures/darkmod/stone/brick/rough_brick_grey
textures/darkmod/city/wall/concrete01	textures/darkmod/stone/flat/slate01_light
textures/darkmod/city/wall/cwall_frame01	textures/darkmod/wood/plaster/framed_02
textures/darkmod/city/wall/cwall_frame02	textures/darkmod/wood/plaster/framed_01
textures/darkmod/city/wall/cwall_framebrick02	textures/darkmod/wood/plaster/framed_with_bricks
textures/darkmod/city/wall/metal01	textures/darkmod/metal/flat/simple_grey01
textures/darkmod/city/roof/rooftile_01	textures/darkmod/roof/shingle_shiny_greenish01
textures/darkmod/litwindows/cwindow01	textures/darkmod/window/square_pattern01_lit
textures/darkmod/litwindows/cwindow01_dark	textures/darkmod/window/square_pattern01_softlit
textures/darkmod/litwindows/cwindow02	textures/darkmod/window/diamond_pattern_andbars01_lit
textures/darkmod/litwindows/hlamp_window01	textures/darkmod/window/pebbly_glass_noframe01_lit
textures/darkmod/city/window/ctywindow01	textures/darkmod/window/diamond_pattern01_lit
textures/darkmod/city/window/ctywindow01b	textures/darkmod/window/diamond_pattern01_dark
textures/darkmod/city/window/ctywindow02	textures/darkmod/window/shutters_grey_closed

textures/darkmod/slate/floor/roof_001	textures/darkmod/roof/slate_uneven_withmoss01
textures/darkmod/slate/floor/roof_002	textures/darkmod/roof/shingle_dullbrown01
textures/darkmod/slate/floor/slate_001	textures/darkmod/stone/flat/rough_slate_dark01

textures/darkmod/metal/gen/bronze_001	textures/darkmod/metal/flat/tiling_1d/gen_smooth_bronze01
textures/darkmod/metal/gen/brushedmetal_001	diffusemap	    textures/darkmod/metal/flat/tiling_1d/gen_shiny_brushedmetal01
textures/darkmod/metal/gen/copper_001	textures/darkmod/metal/flat/tiling_1d/gen_smooth_copper01
textures/darkmod/metal/gen/gold_001	textures/darkmod/metal/flat/tiling_1d/gen_smooth_gold01
textures/darkmod/metal/gen/iron_001	textures/darkmod/metal/flat/tiling_1d/gen_smooth_iron01
textures/darkmod/metal/gen/iron_002	textures/darkmod/metal/flat/tiling_1d/gen_ornate_iron01
textures/darkmod/metal/gen/paintedmetal_001	textures/darkmod/metal/flat/tiling_1d/gen_peeling_paint01
textures/darkmod/metal/gen/rust_001	textures/darkmod/metal/flat/tiling_1d/gen_dark_rusted01
textures/darkmod/metal/gen/silver_001	textures/darkmod/metal/flat/tiling_1d/gen_smooth_silver01

textures/darkmod/grass/floor/dirt_001	textures/darkmod/nature/dirt/dirt_001

textures/darkmod/wood/gen/wood_001	textures/darkmod/wood/boards/tiling_1d/gen_old_boards
textures/darkmod/wood/gen/wood_002	textures/darkmod/wood/panels/tiling_1d/gen_panel_x_pattern

textures/darkmod/ceramic/floor/plaster_002	textures/darkmod/wood/plaster/panel_decorative_white